numero=3
nome=Fuzzy
next=level1.txt
vidas=3
velocidade=0.5f
@@@@@G@@@@@@@
@@@@@@@@@@@@@
@@@@@@@@@@@@@
@@@@@@@@@@@@@
@@@@@@@@@@@@@
@@@@@@@@@@@@@
@@@@@@@@@@@@@
@@@@@@@@@@@@@
@@@@@@@@@@@@@
@@@@@@@@@@@@@
@@@@@RRRRRR@@
@@@@@W@@@@@@@