numero=2
nome=Fuzz
next=level3.txt
vidas=3
velocidade=10.5f
background=backgnd6.png
@@@@@G@@@@@@@
@@@@@@@@@@@@@
@@@@@@@@@@@@@
RRRRRRRRRRRRR
@@@@@@@@@@@@@
RRRRRRRRRRRRR
RRRRRRRRRRRRR
@@@@@@@@@@@@@
@@@@@@@@@@@@@
@@@@@@@@@@@@@
@@@@@@@@@@@@@
RRRRRRRRRRRRR