numero=3
nome=Arrow
next=level1.txt
vidas=3
velocidade=16.0f
background=backgnd3.png
@@@@@@@@@@@@@
WWWWWWWWWWWWW
@WI@@@@@@@IW@
@@W@@@B@@@W@@
@@@W@@@@@W@@@
@@@@W@@@W@@@@
@@@@@W@W@@@@@
@@@@@@W@@@@@@
@@@@@@@@@@@@@
@@@@@@@@@@@@@
@@@@@@@@@@@@@
IIIIIIIIIIIII