numero=2
nome=Fuzz
next=level1.txt
vidas=3
velocidade=0.5f
@@@@@G@@@@@@@
@@@@@@@@@@@@@
@@@@@@@@@@@@@
@W@B@R@G@W@B@
@@@@@@@@@@@@@
@B@B@B@B@B@B@
@B@B@B@B@B@B@
@@@@@@@@@@@@@
@@@@@@@@@@@@@
@@@@@@@@@@@@@
@@@@@@@@@@@@@
@@@@@W@@@@@@@