numero=1
nome=ISEC
next=level2.txt
vidas=3
velocidade=8.0f
background=backgnd5.png
@@@@@@@@@@@@@
WWWWWWWWWWWWW
@@@@@@@@@@@@@
R@RRR@RRR@RRR
B@B@@@B@@@B@@
G@GGG@GGG@G@@
B@@@B@B@@@B@@
W@WWW@WWW@WWW
@@@@@@@@@@@@@
BBBBBBBBBBBBB
@@@@@@@@@@@@@
@@@@@@@@@@@@@