numero=3
nome=Random
next=level4.txt
vidas=3
velocidade=12.0f
background=backgnd4.png
@@@@@@@@@@@@@
@@@@@@@@@@@@@
BBBBBBBBBBBBB
WWWWWWWWWWWWW
GGBBBBGGBBBGG
GBBBGGGGBBBGG
WWWWWWWWWWWWW
RRGGGGRRRGGGG
RGGGGRGGGGRRR
@@@@@@@@@@@@@
@@@@@@@@@@@@@
@@@@@@@@@@@@@